[
----------------------------------|
-                                -|
-                                -|
-                              + -|
-         +                 ------|
-                                -|
-                                -|
-        ***           **        -|
--------------------------       -|
-                                -|
-                                -|
-                                -|
-           +                  + -|
-                                -|
-                                -|
-          ***             **    -|
----------------------------------|
]
/